+---+---+---+---+---+
|           |       |
+---+   +---+---+   +
|   |   |       |   |
+   +   +---+   +   +
|               |   |
+---+   +   +   +   +
|   |   |   |       |
+   +   +---+   +---+
|       |           |
+---+---+---+---+---+