+---+---+---+---+---+---+---+---+---+---+---+---+---+---+---+---+---+---+---+---+
|   |                   |   |   |   |       |       |       |       |           |
+   +---+---+---+---+   +   +   +   +   +   +---+   +   +---+---+   +   +   +   +
|   |               |                   |   |       |       |   |   |   |   |   |
+   +   +---+---+   +   +---+   +---+   +   +   +---+---+   +   +   +---+   +---+
|   |       |   |       |           |   |   |       |                   |   |   |
+   +---+   +   +---+   +---+---+---+   +   +   +---+---+   +   +---+   +   +   +
|               |       |   |   |   |   |                   |       |           |
+   +---+---+   +   +---+   +   +   +   +---+   +---+---+---+   +---+---+---+   +
|   |           |       |               |                   |       |           |
+---+---+---+---+---+---+---+---+---+---+---+---+---+   +---+---+---+---+---+---+
|                                   |       |           |   |   |   |           |
+---+---+---+---+---+---+   +---+---+   +   +   +   +---+   +   +   +   +   +   +
|       |           |   |   |   |       |       |       |           |   |   |   |
+   +   +   +---+   +   +   +   +   +---+---+   +---+   +---+   +---+---+---+   +
|   |           |                   |       |   |       |           |           |
+---+---+---+---+---+---+---+---+   +   +   +   +   +---+---+   +   +---+   +---+
|       |   |   |           |       |   |       |               |   |       |   |
+---+   +   +   +   +---+---+---+   +   +---+---+---+---+---+   +---+   +---+   +
|       |       |   |       |       |   |       |   |       |                   |
+   +---+---+   +   +   +   +   +---+   +   +   +   +   +   +   +---+---+   +---+
|       |               |   |       |       |   |       |           |           |
+---+   +---+   +---+   +---+   +---+---+---+   +---+---+---+---+---+---+---+---+
|       |       |                   |   |   |   |   |   |   |   |               |
+---+   +---+---+---+---+---+---+   +   +   +   +   +   +   +   +---+   +---+---+
|       |   |           |   |       |               |           |       |   |   |
+   +---+   +   +---+   +   +   +---+---+   +---+---+   +---+   +   +   +   +   +
|       |           |   |           |                   |   |   |   |   |       |
+   +---+---+---+   +   +   +---+---+   +   +---+   +   +   +   +   +---+   +   +
|   |   |           |       |       |   |   |       |       |   |           |   |
+   +   +---+---+   +   +   +   +   +---+---+---+   +---+---+---+---+---+   +---+
|                   |   |       |   |           |   |           |               |
+   +---+---+---+---+---+   +---+---+   +   +   +   +---+   +---+---+   +---+---+
|       |                           |   |   |       |           |       |       |
+---+---+---+---+---+---+---+---+   +   +---+   +---+   +---+---+---+   +   +   +
|   |                       |   |   |       |                           |   |   |
+   +   +   +---+---+   +   +   +   +---+---+   +---+   +---+---+   +   +   +---+
|   |   |       |   |   |   |       |       |       |   |       |   |   |   |   |
+   +   +---+   +   +   +   +   +   +   +   +   +   +   +   +   +---+   +   +   +
|       |           |   |       |   |   |       |   |       |   |               |
+---+---+---+---+---+---+---+---+---+---+---+---+---+---+---+---+---+---+---+---+