+---+---+---+---+---+
|           |       |
+---+---+   +---+   +
|       |       |   |
+   +---+   +---+   +
|                   |
+   +   +   +---+   +
|   |   |   |       |
+   +---+   +---+   +
|       |   |       |
+---+---+---+---+---+