######################
##      ##          ##
######  ##  ######  ##
##  ##          ##  ##
##  ##  ##  ##########
##      ##          ##
##########  ##########
##  ##              ##
##  ##  ##  ######  ##
##      ##  ##      ##
######################

